00,00,00,00,00,00,00,00,00,00,00,00,00,00,00,00,50,00,
00,00,00,00,00,00,00,50,50,50,50,50,00,00,00,00,50,00,
00,00,00,00,00,00,00,00,00,00,00,50,50,50,50,00,50,00,
00,00,00,00,00,00,00,00,00,00,00,50,00,00,50,50,50,00,
00,00,50,00,00,50,50,50,50,50,50,50,00,00,00,00,00,00,
00,00,50,00,00,00,00,00,00,00,00,50,00,00,00,00,00,00,
00,00,50,00,00,00,00,00,00,00,00,50,00,00,00,00,00,00,
00,00,50,50,50,50,50,50,00,00,00,50,00,00,00,00,00,00,
00,00,00,00,00,00,00,50,00,00,00,50,00,50,50,50,00,00,
50,50,50,50,00,00,00,50,00,00,00,50,00,50,00,50,00,00,
00,00,00,50,00,00,00,50,00,00,00,50,00,50,00,50,00,00,
00,00,00,50,50,50,50,50,00,00,00,50,50,50,00,50,00,00,